{
  "maps": [
    {
      "name": "Map Classique",
      "description": "Map par défaut du jeu Bomberman",
      "width": 15,
      "height": 13,
      "created": "2025-06-10T19:00:00",
      "author": "System",
      "matrix": [
        [1,1,1,1,1,1,1,1,1,1,1,1,1,1,1],
        [1,0,0,2,2,2,2,2,2,2,2,2,2,0,1],
        [1,0,1,2,1,2,1,2,1,2,1,2,1,0,1],
        [1,2,2,2,2,2,2,2,2,2,2,2,2,2,1],
        [1,2,1,2,1,2,1,2,1,2,1,2,1,2,1],
        [1,2,2,2,2,2,2,2,2,2,2,2,2,2,1],
        [1,2,1,2,1,2,1,2,1,2,1,2,1,2,1],
        [1,2,2,2,2,2,2,2,2,2,2,2,2,2,1],
        [1,2,1,2,1,2,1,2,1,2,1,2,1,2,1],
        [1,2,2,2,2,2,2,2,2,2,2,2,2,2,1],
        [1,2,1,2,1,2,1,2,1,2,1,2,1,0,1],
        [1,0,2,2,2,2,2,2,2,2,2,2,0,0,1],
        [1,1,1,1,1,1,1,1,1,1,1,1,1,1,1]
      ]
    },
    {
      "name": "Map_1Test",
      "description": "Map créée avec l'éditeur",
      "width": 15,
      "height": 13,
      "created": "2025-06-11T12:03:17.971517432",
      "author": "Anonyme",
      "matrix": [
        [1,1,1,1,1,1,1,1,1,1,1,1,1,1,1],
        [1,0,0,2,2,2,2,2,2,2,2,2,2,2,1],
        [1,0,2,2,2,1,2,2,2,1,2,2,2,2,1],
        [1,2,1,2,2,1,2,2,2,2,2,2,2,2,1],
        [1,1,2,2,2,1,2,1,2,2,2,2,2,2,1],
        [1,2,2,1,2,2,2,2,2,2,2,2,2,2,1],
        [1,2,2,2,2,1,2,2,1,2,2,2,2,1,1],
        [1,2,2,2,2,2,2,2,1,2,2,2,2,2,1],
        [1,2,2,1,2,2,2,2,2,2,2,2,2,2,1],
        [1,2,2,2,2,2,2,2,2,2,2,2,2,2,1],
        [1,2,2,2,2,2,2,2,2,2,2,2,2,0,1],
        [1,2,2,2,2,2,2,1,2,2,2,2,0,0,1],
        [1,1,1,1,1,1,1,1,1,1,1,1,1,1,1]
      ]
    },
    {
      "name": "Map_Custom",
      "description": "Map créée avec l'éditeur",
      "width": 15,
      "height": 13,
      "created": "2025-06-10T19:40:11.096707027",
      "author": "Anonyme",
      "matrix": [
        [1,1,1,1,1,1,1,1,1,1,1,1,1,1,1],
        [1,0,0,1,2,2,2,2,2,2,2,2,2,2,1],
        [1,0,1,1,2,2,2,1,2,1,2,2,2,2,1],
        [1,2,1,2,2,2,2,2,2,2,2,2,2,2,1],
        [1,2,1,2,2,2,2,1,1,1,2,2,2,2,1],
        [1,2,2,2,1,2,2,2,2,2,2,2,2,2,1],
        [1,2,1,2,2,2,1,2,2,1,2,2,2,2,1],
        [1,2,2,2,2,2,2,2,2,1,2,2,2,2,1],
        [1,2,2,2,1,2,2,2,2,1,2,2,2,2,1],
        [1,2,2,2,2,2,2,2,2,2,2,2,2,2,1],
        [1,2,2,2,2,2,2,2,2,2,2,2,2,0,1],
        [1,2,2,2,2,2,2,2,2,2,2,2,0,0,1],
        [1,1,1,1,1,1,1,1,1,1,1,1,1,1,1]
      ]
    },
    {
      "name": "map",
      "description": "Map créée avec l'éditeur",
      "width": 15,
      "height": 13,
      "created": "2025-06-11T18:22:24.356430419",
      "author": "Anonyme",
      "matrix": [
        [1,1,1,1,1,1,1,1,1,1,1,1,1,1,1],
        [1,0,0,2,2,2,2,2,2,2,2,2,2,2,1],
        [1,0,2,2,2,2,2,2,2,2,2,2,2,2,1],
        [1,2,2,2,2,2,2,2,2,2,2,2,2,2,1],
        [1,2,2,2,2,2,2,2,2,2,2,2,2,2,1],
        [1,2,2,2,2,2,2,2,2,2,2,2,2,2,1],
        [1,2,2,2,2,2,2,2,2,2,2,2,2,2,1],
        [1,2,2,2,2,2,2,2,2,2,2,2,2,2,1],
        [1,2,2,2,2,2,2,2,2,2,2,2,2,2,1],
        [1,2,2,2,2,2,2,2,2,2,2,2,2,2,1],
        [1,2,2,2,2,2,2,2,2,2,2,2,2,0,1],
        [1,2,2,2,2,2,2,2,2,2,2,2,0,0,1],
        [1,1,1,1,1,1,1,1,1,1,1,1,1,1,1]
      ]
    }
  ],
  "metadata": {
    "version": "1.0",
    "totalMaps": 4,
    "lastUpdated": "2025-06-11T18:22:24.361973863"
  }
}